1111111111111111111111111111111111111111111111111111
1000000000000000010000000000000000000000000000000001
1000000001000000100000000000000000000000000000000001
1000000001000000010000000000000000000000000000000001
1000000001100000010000000000000000000000000000000001
1000000001000000010000000000000000000000000000000001
1000000001100000100000000000000000000000000000000001
1000P00001000000100000000000000000000000000000000001
1111111111000000100000000000000000000000000000000001
1000000000000000100000000000000000000000000000000001
1000000000000000100000000000000000000000000000000001
1000000000000000100000000000000000000C00000000000001
1000000000000000100000000000000000000000000000000001
1000000000000000100000000000000000000000000000000001
1000000000000000000000000000000000000000000000000001
1000000000111111111111111111111111111111100000000001
1000000000000001000000000000000000000000000000000001
1000000000000001000000000000000000000000000000000001
1000000000000001000011111111111111111111111111100001
1000000000000001000000000000000000000000100000000001
1000000000000001000000000000000000000C00100000000001
1000000000000001111100000000000000000000100000000001
10000000000000010E0100111111111111111111100000000001
1000000000000001000100000000000000000000000000000001
1000000000000001000111111111111111111111111111110001
1000000000000000000000000000000000000000000000000001
1111111111111111111111111111111111111111111111111111