1111111111
10000C0001
100E000P01
1111111111