111111111111111111111111111111111111111111111111111
1000000000000000C0000000000000000000000000000000001
100000011111111111111111111111111111111111100000001
100000011111111111111111111111111111111111100000001
1000C0011110000000000011000000000000001111100000001
100000011100000000000011000000000000011111000000001
100000011000000000000011000000000000111110000000001
100000010000000000000011000000000011111000000000001
1000000000000000C0000011000000001111100000000000001
1000000000000000000000110000001111100000000000C0001
100000000000000000000011000011111000000000000000001
100000000000000000000011000111110000000000000000001
100000000000000000000011001111100000000000000000001
100000000000000000000011011110000000000000000000001
100000000000000000000011111000000000000000000000001
100000000000000000001111000000000000000000000000001
100000000000000000111111000000000000000000000000001
10P000000000000011111011000000000000000000000000001
100000000000001111100011000000000000000000010000001
100000000000111110000011000000000000000000110000001
1000000001111110000000110000C0000000000001110000001
100000011111100000000011000000000000000011110000E01
100000011111111111111111111111111111111111110000001
100000011111111111111111111111111111111111110000001
1000C000000000000000000000000C000000000000000000001
100000000000000000000000000000000000000000000000001
111111111111111111111111111111111111111111111111111